###########################################################
#                                 #                       # 
# ^@                              #  Test   TEST          # 
#                                 #  1234 ()&*$!          # 
#                                 #                       # 
#                                 ######################### 
#                                                         # 
#                                                         # 
#           ┌─────────────────────────────────┐           # 
#           │ NOW WITH ШІ▷Ξ CHARACTER SUPPORT │           # 
#           └────╥─────────────────────╥──────┘           # 
#                ║ colors coming soon™ ║                  # 
#                ╚═════════════════════╝                  # 
#                                                         # 
#                                                         # 
#                                                         # 
########################   ################################
#                                                         # 
#                                                         # 
#                                                         # 
#                                                         # 
#               #                                         # 
#              #  #                                       # 
#               #  #                                      # 
#                #  #                                     # 
#                 ##                                      # 
#                                                         # 
#                                                         # 
#                                                         # 
#                                                         # 
#                                   ##  ####              # 
#                                   ##  ####              # 
#                                                         # 
#                                              < >        # 
#                                                         # 
#                                                         # 
###########################################################
