###########################################################
#                                 #                       #
#                                 #  Test   TEST          #
#                                 #  1234 ()&*$!          #
#                                 #                       #
#                                 #########################
#                                                         #
#                                                         #
#           ┌─────────────────────────────────┐           #
#           │ NOW WITH ШІ▷Ξ CHARACTER SUPPORT │           #
#           └────╥─────────────────────╥──────┘           #
#                ║ colors coming soon™ ║                  #
#                ╚═════════════════════╝                  #
#                                                         #
#                                                         #
#                                                         #
########################   ################################
#                                                         #
#                                                         #
#                                                         #
                          ^@                               
#       #       See if you can overflow my vars           #                                                                                                                                                                                                     Yea I'm bored too...                                                                                                                                                                                                                   Next update I'm adding teleporters
#      #  #     Only  2147483647 characters this way -->  #
#       #  #    I guess you can call this a quest..       #
#        #  #                                             #
#         ##                                              #
#                                                         #
#                                                         #
#                                                         #
#                                                         #
#                                   ##  ####              #
#                                   ##  ####              #
#                                                         #
#                                              < >        #
#                                                         #
#                                                         #
######################### #################################
                        # #
                        # #
                        # #
                        # #
                        # #
                        # #
                        # #
                        # #
                        # #
                        # #
                        # #
                        # #
                        # #
                        # #
######################### #################################
#                                                         #
#                                                         #
#         NOW WITH WIDE (and tall) MAP SUPPORT            #
#                                                         #
#                                                         #
###########################################################
